//MAP CONVERTED BY dmm2tgm.py THIS HEADER COMMENT PREVENTS RECONVERSION, DO NOT REMOVE
"a" = (
/turf/template_noop,
/area/template_noop)
"j" = (
/obj/structure/table/halflife/metal/heavy,
/turf/open/floor/plating/indoor/metal/combine,
/area/shuttle/transport)
"m" = (
/obj/structure/fans/tiny/invisible,
/obj/docking_port/mobile{
	dir = 8;
	dwidth = 2;
	height = 13;
	name = "ferry shuttle";
	port_direction = 1;
	preferred_direction = 4;
	shuttle_id = "ferry";
	width = 5
	},
/obj/machinery/door/airlock/highsecurity/combine,
/obj/effect/mapping_helpers/airlock/access/all/admin/captain,
/turf/open/floor/plating/indoor/metal/combine,
/area/shuttle/transport)
"t" = (
/obj/structure/shuttle/engine/propulsion{
	dir = 8
	},
/turf/closed/wall/mineral/titanium,
/area/shuttle/transport)
"u" = (
/obj/structure/chair/comfy/halflife/captain{
	dir = 4
	},
/turf/open/floor/plating/indoor/metal/combine,
/area/shuttle/transport)
"z" = (
/obj/machinery/computer/shuttle/ferry/request{
	dir = 8
	},
/turf/open/floor/plating/indoor/metal/combine,
/area/shuttle/transport)
"K" = (
/turf/closed/wall/halflife/metal,
/area/shuttle/transport)
"L" = (
/obj/structure/chair/comfy/halflife/captain{
	dir = 1
	},
/obj/machinery/light/small,
/turf/open/floor/plating/indoor/metal/combine,
/area/shuttle/transport)
"P" = (
/turf/open/floor/plating/indoor/metal/combine,
/area/shuttle/transport)
"R" = (
/obj/structure/chair/comfy/halflife/captain{
	dir = 1
	},
/turf/open/floor/plating/indoor/metal/combine,
/area/shuttle/transport)
"S" = (
/obj/structure/chair/comfy/halflife/captain,
/turf/open/floor/plating/indoor/metal/combine,
/area/shuttle/transport)
"X" = (
/obj/structure/chair/comfy/halflife/captain,
/obj/machinery/light/small{
	dir = 1
	},
/turf/open/floor/plating/indoor/metal/combine,
/area/shuttle/transport)

(1,1,1) = {"
a
a
a
a
a
"}
(2,1,1) = {"
a
t
a
t
a
"}
(3,1,1) = {"
t
K
K
K
t
"}
(4,1,1) = {"
K
u
P
j
K
"}
(5,1,1) = {"
K
z
P
j
K
"}
(6,1,1) = {"
K
S
P
R
K
"}
(7,1,1) = {"
K
S
P
R
K
"}
(8,1,1) = {"
K
S
P
R
K
"}
(9,1,1) = {"
K
X
P
L
K
"}
(10,1,1) = {"
K
S
P
R
K
"}
(11,1,1) = {"
K
S
P
R
K
"}
(12,1,1) = {"
K
S
P
R
K
"}
(13,1,1) = {"
K
K
m
K
K
"}
